XXXXXXXXXXXXXXXXXXXXXXXXX
X                       X
X                       X
X                       X
X  P                    X
XXXXXXX                 X
X           J           X
X         XXXXXX        X
X                       X
X                 J     X
X               XXXXX   X
X                       X
X   XXXX                X
X          L            X
X        XXXXX          X
X                       X
X                       X
XXXXXXXXXXXXXXXXXXXXXXXXX