LLLLLLLLLL         XLLLLL
L            JJJJJJX   PL
L           XXXXXXXX  XXL
L                       L
L        XX             L
L                        
L      XX                
L                     XX 
L    XX                L 
L                      L 
L  XX                  L 
L                      L 
LXX    XLLLLLLLLLLLLLLLL 
LLXX    XXLLLLLLLLLLLLLL 
LLLXX     XLLLLLLLLLLLLL 
LLLLXXX                  
LLLLLLLXX                
LLLLLLLLLXXXXXXXXXXXXXXX