XXXXXXXXXXXXXXXXXXXXXXXXX
X                       X
X                       X
X                       X
X  P         J          X
XXXXXX      XXXXX       X
X                       X
X            L          X
X          XXXXXX       X
X     J                 X
X   XXXXX               X
X                       X
XXXXXXXXXXXXXXXXXXXXXXXXX