LLLLLLLLLL        XLLLLLL
L            JJJJJX    PL
L           XXXXXXX  XXXL
L                       L
L        XX             L
L                       X
L      XX               X
L                    XX X
L    XX                 X
L                       X
L  XX                   X
L                       X
LXX    XLLLLLLLLLLLLLLL X
LLXX    XXLLLLLLLLLLLLL X
LLLXX     XLLLLLLLLLLLL X
LLLLXXX                 X
LLLLLLLXX               X
LLLLLLLLLXXXXXXXXXXXXXXXX